10 10 25 25
0 0 0 0 0 10 0 0 0 0 
0 0 0 0 -1 -1 -1 -1 -1 G 
-1 -1 0 -1 0 0 0 0 -1 0 
0 0 0 -1 -1 -1 -1 0 0 0 
0 0 0 0 0 0 7 0 -1 0 
0 -1 -1 -1 -1 0 0 0 -1 0 
0 -1 S -1 -1 -1 0 0 -1 -1 
0 -1 0 -1 0 0 0 -1 -1 -1 
0 0 0 -1 0 0 0 0 0 0 
-1 -1 -1 -1 0 0 0 0 0 -1
