25 25 100 100
0 0 0 0 0 0 0 0 0 0 0 0 0 0 0 0 0 0 4 0 0 0 0 0 0
0 -1 0 0 0 0 0 0 0 0 0 0 G 0 0 0 0 -1 0 0 0 0 0 0 0
0 -1 0 0 9 -1 -1 -1 -1 -1 -1 0 0 0 0 -1 -1 -1 -1 -1 -1 0 0 0 0
0 -1 -1 -1 0 -1 0 0 0 0 0 0 0 0 0 0 0 -1 0 0 0 0 0 0 0
0 0 0 0 1 -1 0 0 0 -1 -1 -1 -1 0 0 0 0 -1 0 -1 0 2 0 0 0
-1 -1 -1 -1 0 -1 -1 -1 -1 -1 -1 0 0 0 0 0 0 0 0 -1 0 0 0 0 0
0 0 0 -1 0 -1 0 0 0 0 0 0 0 0 0 0 0 0 0 -1 0 0 -1 -1 -1
0 -1 0 -1 0 0 0 0 0 0 0 0 0 0 0 -1 -1 -1 -1 -1 -1 0 0 0 0
0 -1 0 -1 0 0 0 0 0 0 0 0 0 0 0 -1 0 0 0 0 0 0 -1 -1 -1
0 -1 0 -1 -1 -1 0 1 0 0 0 0 0 -1 9 -1 0 0 0 0 0 0 0 0 0
0 -1 0 0 0 -1 0 0 0 0 0 0 0 -1 9 -1 0 0 0 0 -1 -1 -1 -1 0
0 -1 -1 0 0 -1 0 0 0 0 0 0 0 -1 9 -1 0 0 0 -1 0 0 0 0 0
0 0 -1 0 0 -1 0 0 0 0 0 0 0 -1 9 -1 0 0 0 -1 0 0 0 0 0
0 0 -1 0 0 -1 0 -1 -1 -1 -1 -1 -1 -1 9 -1 -1 0 0 -1 0 0 1 0 0
0 0 -1 0 0 -1 3 0 0 0 0 0 0 9 9 -1 -1 -1 -1 -1 0 0 0 0 0
0 0 -1 0 0 2 0 -1 -1 -1 -1 -1 -1 9 9 0 -1 0 0 0 0 0 0 0 0
0 0 -1 0 0 -1 0 -1 0 0 0 -1 0 0 -1 -1 -1 0 0 0 5 0 0 0 0
0 0 -1 0 0 -1 0 -1 0 -1 0 -1 0 0 -1 0 0 0 0 0 0 0 0 0 0
-1 0 -1 0 0 -1 0 -1 0 -1 -1 -1 0 0 -1 -1 -1 -1 -1 -1 0 0 0 0 0
-1 0 -1 0 0 0 0 0 0 0 0 -1 0 0 0 0 0 -1 0 0 0 0 0 0 0
-1 0 -1 -1 -1 -1 -1 -1 -1 -1 0 -1 -1 -1 -1 0 -1 -1 -1 0 0 -1 -1 -1 -1
-1 0 0 0 8 1 0 0 0 0 0 0 -1 -1 -1 0 -1 -1 0 0 0 0 0 0 0
-1 0 0 0 -1 0 2 -1 -1 -1 -1 -1 -1 -1 0 0 0 -1 0 0 0 0 0 7 0
-1 0 0 0 -1 0 -1 -1 0 0 0 0 0 -1 0 -1 0 -1 -1 -1 -1 -1 -1 -1 0
-1 0 0 0 -1 0 0 0 3 -1 S -1 0 0 0 -1 0 0 0 0 0 0 0 0 0