28 40 100 100
-1 -1 -1 0 0 0 -1 -1 -1 -1 -1 -1 -1 -1 -1 -1 0 0 0 0 0 0 0 0 0 -1 -1 0 0 0 5 0 -1 0 0 0 0 0 0 0 
-1 0 0 0 0 0 -1 0 0 0 -1 0 -1 0 0 G 0 0 0 0 0 0 0 -1 -1 -1 -1 0 0 0 -1 0 -1 0 0 0 0 0 0 0 
0 0 0 0 0 0 0 0 0 0 -1 0 -1 0 0 0 0 -1 -1 -1 0 0 0 0 0 0 0 0 -1 -1 -1 0 0 0 0 0 0 0 0 0 
0 0 0 0 0 0 0 -1 0 0 0 0 -1 0 0 0 0 0 0 0 0 0 0 0 0 0 0 0 0 0 -1 0 0 -1 -1 -1 -1 -1 -1 -1 
0 0 0 -1 0 0 0 -1 0 0 0 0 -1 0 0 0 -1 -1 -1 -1 -1 -1 -1 0 -1 0 0 0 0 0 -1 0 0 0 0 0 0 -1 -1 -1 
0 0 0 -1 0 0 0 -1 0 0 -1 0 -1 0 0 0 0 0 0 0 0 0 0 0 -1 0 0 0 0 0 -1 0 0 0 -1 -1 -1 -1 -1 0 
0 0 0 -1 0 0 0 0 0 4 -1 0 0 0 0 0 0 0 0 0 0 0 0 -1 -1 -1 -1 -1 -1 -1 0 0 0 0 0 6 0 0 0 0 
0 0 0 5 0 0 -1 -1 0 -1 -1 0 0 0 0 0 0 0 0 0 -1 -1 -1 -1 -1 -1 0 -1 0 -1 0 0 0 0 -1 0 0 0 0 0 
0 0 0 0 1 0 0 0 0 0 -1 0 0 0 0 0 0 0 0 0 -1 0 0 0 0 0 0 -1 0 -1 0 0 0 0 -1 0 0 8 0 0 
0 -1 0 0 0 0 -1 0 0 0 0 0 0 0 0 0 0 -1 0 0 -1 0 0 0 -1 0 0 -1 0 0 0 0 -1 -1 -1 -1 -1 -1 0 0 
0 -1 -1 -1 0 -1 -1 -1 -1 0 0 0 0 0 -1 0 0 -1 0 0 -1 0 -1 0 0 0 0 -1 0 0 0 0 0 -1 -1 -1 -1 -1 -1 0 
-1 -1 0 0 0 0 0 0 -1 -1 0 0 0 0 -1 0 0 -1 0 0 -1 0 0 0 -1 -1 -1 -1 0 -1 0 0 -1 -1 -1 0 0 0 0 0 
-1 -1 -1 -1 -1 -1 0 0 -1 -1 0 0 0 0 -1 0 0 -1 0 0 -1 0 3 0 0 0 -1 -1 0 -1 0 0 0 0 -1 -1 -1 -1 -1 -1 
-1 -1 -1 -1 -1 0 0 0 -1 -1 0 0 0 -1 -1 -1 -1 -1 -1 0 -1 0 0 0 0 0 -1 -1 0 -1 0 0 0 0 -1 -1 -1 0 0 0 
-1 -1 -1 -1 -1 0 0 0 -1 -1 0 0 0 0 -1 -1 0 0 0 0 -1 -1 -1 4 5 0 0 -1 0 -1 -1 -1 -1 -1 0 0 0 0 0 0 
0 0 0 0 0 0 -1 -1 -1 -1 -1 -1 -1 0 0 -1 0 0 0 0 -1 -1 -1 0 0 0 0 -1 0 -1 0 0 0 0 -1 -1 -1 0 0 0 
0 0 0 0 0 -1 0 0 0 -1 9 0 0 0 -1 -1 -1 -1 -1 -1 -1 -1 -1 -1 0 0 0 0 0 0 0 0 0 0 0 0 0 0 0 0 
0 0 -1 0 0 0 0 0 0 -1 0 -1 -1 -1 -1 -1 0 0 0 0 -1 0 0 0 0 0 0 0 -1 0 0 0 0 0 0 0 0 0 8 0 
0 0 -1 0 9 0 0 0 0 -1 0 0 0 0 0 0 0 -1 0 0 0 0 0 0 0 0 0 0 0 -1 0 0 0 0 0 0 0 -1 -1 -1 
0 -1 -1 -1 -1 -1 -1 0 0 0 0 0 0 0 0 0 0 0 0 0 0 -1 -1 -1 0 0 0 0 0 -1 0 0 -1 -1 0 10 10 0 -1 -1 
0 0 -1 0 -1 0 0 0 0 0 0 0 0 0 0 0 0 0 0 0 0 0 0 0 0 0 0 0 0 -1 0 0 0 0 0 0 0 0 -1 -1 
0 0 -1 0 -1 0 -1 0 0 0 0 -1 -1 -1 -1 -1 0 0 0 0 0 0 0 0 0 0 0 0 0 -1 0 -1 0 0 -1 0 0 0 0 -1 
5 0 -1 0 -1 -1 -1 -1 -1 0 0 0 0 0 0 0 -1 -1 -1 0 0 0 0 0 0 0 0 0 0 -1 0 -1 0 0 -1 0 0 0 0 0 
0 0 0 0 -1 -1 -1 0 0 0 0 0 0 0 -1 0 0 0 0 0 0 0 0 -1 0 0 0 0 0 -1 -1 -1 0 0 -1 -1 -1 0 0 1 
0 0 0 0 10 0 -1 0 9 0 0 0 0 -1 -1 0 0 0 0 0 0 0 0 -1 0 0 0 0 -1 0 -1 -1 -1 -1 -1 -1 -1 0 0 6 
0 0 0 0 3 0 -1 0 0 0 0 0 0 0 -1 0 0 0 0 0 0 0 0 -1 -1 -1 -1 -1 -1 0 0 -1 0 0 0 -1 -1 -1 -1 0 
0 0 0 0 0 0 -1 0 0 0 0 0 0 0 -1 0 -1 -1 -1 0 0 0 0 0 0 0 0 0 0 0 -1 -1 -1 -1 0 0 0 0 0 0 
0 0 0 0 0 0 0 0 0 -1 -1 -1 -1 0 -1 -1 -1 -1 -1 0 0 0 0 0 0 0 0 0 0 0 0 S 0 0 0 0 0 0 0 0 