10 10 100 100
0 0 0 -1 -1 -1 0 0 0 0 
0 0 0 0 0 0 0 0 0 0 
0 -1 -1 -1 -1 -1 0 0 0 0 
S -1 -1 0 0 0 0 0 0 -1 
-1 -1 -1 0 -1 -1 0 0 0 0 
-1 0 0 0 0 0 -1 -1 0 0 
-1 0 0 -1 0 0 0 0 0 0 
-1 0 0 -1 -1 -1 -1 0 0 0 
G 0 0 -1 0 0 0 0 0 0 
0 0 -1 -1 -1 -1 -1 0 -1 -1 
