10 10 100 100
0 0 0 3 8 0 0 0 0 0 
0 -1 0 S 0 0 0 2 0 F5 
0 -1 -1 -1 -1 -1 0 10 -1 -1 
-1 0 G -1 -1 -1 0 0 0 0 
0 8 0 0 0 -1 0 0 0 0 
0 -1 0 0 -1 -1 0 0 0 0 
0 -1 0 0 0 -1 -1 -1 0 0 
0 -1 0 0 0 0 1 -1 0 0 
0 0 0 0 0 -1 0 0 0 -1 
-1 -1 -1 0 0 -1 F4 0 0 -1 
