15 15 100 100
0 0 0 0 0 0 0 0 0 -1 -1 -1 -1 -1 -1 
S 0 -1 0 0 0 0 1 0 -1 0 0 0 -1 0 
0 0 -1 0 0 0 0 3 0 -1 0 0 0 F1 0 
0 0 0 0 -1 -1 0 0 F5 -1 0 0 0 0 0 
0 0 -1 0 -1 0 0 0 0 -1 -1 0 0 0 0 
0 7 -1 0 -1 0 0 0 0 0 0 0 0 0 0 
-1 -1 -1 -1 -1 0 0 0 0 0 0 0 -1 -1 -1 
-1 -1 -1 -1 -1 -1 -1 -1 5 0 0 -1 -1 -1 -1 
0 0 0 0 0 -1 -1 -1 0 0 0 -1 0 0 0 
F1 0 0 0 0 0 0 0 0 0 0 -1 0 0 0 
0 0 0 0 0 8 0 0 0 0 0 -1 0 0 -1 
-1 0 0 0 0 0 0 0 0 0 0 1 0 0 0 
G 10 0 0 0 0 -1 -1 -1 -1 -1 0 -1 0 0 
0 0 0 0 -1 -1 -1 -1 -1 0 0 0 -1 0 0 
0 0 0 0 -1 0 0 0 0 0 -1 0 -1 0 0 
