20 20 40 20
0 F1 0 0 0 0 0 0 -1 0 0 0 0 0 0 0 0 -1 -1 -1 
10 0 0 0 0 0 0 0 0 0 0 0 0 0 0 0 F2 0 0 0 
0 0 0 0 0 0 0 -1 -1 0 0 0 0 0 0 0 0 0 0 5 
0 1 0 0 0 0 0 -1 -1 -1 0 0 S 0 0 0 -1 -1 0 0 
0 0 F4 0 0 0 -1 -1 -1 -1 -1 -1 -1 0 0 0 -1 0 0 0 
0 0 -1 -1 -1 -1 -1 -1 -1 -1 0 F9 0 0 -1 0 -1 0 0 0 
0 0 0 -1 -1 -1 0 0 -1 -1 0 0 0 0 0 0 -1 2 0 0 
0 -1 -1 0 0 0 0 0 -1 -1 0 0 0 -1 0 0 -1 -1 -1 -1 
0 0 F2 -1 -1 0 0 0 -1 -1 0 0 0 0 0 0 -1 0 0 0 
0 0 0 -1 0 0 0 0 1 0 0 0 0 0 0 0 -1 0 F1 9 
5 0 0 -1 4 -1 5 0 -1 0 0 0 0 0 0 0 -1 0 1 0 
0 0 0 -1 0 -1 0 0 -1 0 -1 0 8 0 0 0 -1 0 -1 0 
0 0 0 0 0 -1 0 0 -1 0 -1 0 0 0 0 0 -1 0 -1 0 
0 0 0 0 0 -1 -1 0 -1 0 F3 -1 -1 -1 -1 -1 -1 -1 0 0 
0 0 0 0 0 -1 -1 0 -1 0 0 0 0 0 0 0 0 0 0 0 
0 0 -1 -1 -1 -1 -1 -1 -1 -1 -1 0 0 0 0 0 -1 -1 -1 -1 
0 0 0 -1 -1 -1 -1 -1 -1 0 0 0 0 0 0 -1 -1 -1 0 0 
0 0 0 0 G -1 -1 0 -1 0 -1 -1 -1 -1 -1 -1 -1 0 0 0 
-1 0 0 0 0 0 -1 0 -1 0 0 0 0 0 0 0 0 0 0 0 
-1 0 0 0 0 0 0 0 0 0 0 0 0 0 1 0 -1 0 0 7 