25 25 90 70
0 0 0 0 0 0 0 -1 -1 -1 -1 -1 0 0 0 0 7 0 0 0 -1 -1 -1 -1 -1 
0 0 0 -1 -1 0 0 -1 -1 -1 -1 0 0 0 0 0 0 0 0 0 -1 0 0 0 0 
0 0 0 -1 -1 0 0 6 0 9 0 0 0 0 0 0 0 0 0 10 -1 5 0 0 0 
0 0 0 -1 -1 -1 -1 -1 -1 -1 -1 -1 -1 -1 7 0 0 0 0 0 -1 0 0 0 6 
0 9 0 -1 -1 0 -1 G 0 0 0 0 2 0 -1 0 0 -1 -1 -1 -1 -1 -1 0 0 
0 0 0 -1 -1 2 -1 0 0 0 6 -1 0 0 -1 0 0 0 0 0 0 0 -1 0 0 
0 0 0 -1 -1 0 -1 0 0 0 0 -1 0 0 -1 0 0 0 0 0 0 0 0 0 0 
0 -1 0 0 -1 0 -1 0 0 0 0 -1 0 0 -1 0 0 0 0 0 0 0 0 0 0 
0 -1 0 0 -1 0 0 0 -1 0 0 -1 0 0 -1 0 0 0 0 0 0 -1 -1 -1 -1 
0 -1 -1 -1 -1 0 0 0 3 0 0 -1 0 0 -1 0 0 0 0 S 0 0 0 0 0 
0 -1 0 0 0 -1 -1 -1 -1 -1 -1 0 0 0 -1 0 0 0 0 0 0 0 0 F1 0 
0 -1 0 0 0 0 0 -1 0 0 0 0 0 0 -1 0 0 0 0 0 0 0 0 0 0 
0 -1 0 0 0 0 0 0 0 0 0 -1 -1 0 -1 0 0 0 0 0 0 -1 -1 -1 -1 
0 -1 0 0 0 0 0 0 0 0 F1 0 0 0 0 -1 -1 -1 -1 -1 -1 -1 -1 -1 -1 
0 -1 0 -1 -1 -1 -1 -1 -1 -1 -1 0 0 0 0 0 0 0 0 0 0 0 0 -1 0 
0 -1 0 0 0 0 0 -1 -1 -1 -1 -1 -1 -1 -1 0 0 0 0 0 0 0 0 -1 0 
0 0 0 0 0 0 0 0 0 0 0 0 0 0 -1 -1 -1 -1 -1 0 0 1 0 -1 0 
0 0 0 -1 -1 -1 -1 -1 -1 0 0 0 0 0 0 0 6 0 0 0 0 0 0 -1 0 
F5 0 0 0 0 5 0 0 -1 -1 -1 -1 -1 -1 -1 -1 0 0 0 0 0 0 0 -1 0 
0 0 0 0 0 0 0 0 -1 0 0 0 0 0 0 0 0 0 0 0 0 -1 0 -1 0 
0 0 0 0 0 0 0 0 0 0 0 0 0 0 0 0 0 0 0 0 1 -1 0 0 0 
0 0 0 -1 0 0 0 0 -1 0 0 4 0 -1 0 0 0 0 0 0 0 0 0 0 -1 
0 0 0 -1 0 0 0 0 -1 0 0 0 3 -1 0 0 0 0 0 0 0 0 0 0 0 
0 0 0 -1 0 6 0 5 -1 0 0 0 0 -1 0 0 0 F3 0 0 0 0 0 0 0 
0 0 0 -1 0 -1 0 0 -1 0 -1 0 0 -1 -1 -1 -1 -1 0 0 0 0 0 0 0 