28 40 100 100
0 -1 -1 -1 -1 0 0 0 0 0 0 0 0 -1 0 0 0 0 -1 0 0 0 0 0 0 0 -1 -1 -1 -1 -1 0 0 0 0 0 0 0 0 0 
8 -1 0 0 0 0 0 0 G -1 0 0 0 0 0 0 0 0 -1 0 0 0 0 0 0 0 -1 0 0 0 0 -1 0 -1 -1 -1 -1 -1 -1 0 
0 -1 0 0 0 0 0 0 0 -1 0 0 0 0 0 -1 0 -1 0 -1 0 0 -1 0 0 0 -1 0 7 0 0 -1 F5 -1 -1 -1 -1 0 0 0 
0 -1 -1 7 -1 -1 -1 -1 -1 -1 0 0 0 -1 0 0 -1 0 0 -1 -1 0 -1 0 0 -1 -1 -1 0 0 0 0 0 -1 0 0 0 0 0 0 
0 -1 -1 -1 -1 -1 -1 -1 -1 -1 0 0 0 -1 0 0 -1 0 0 -1 0 0 0 0 0 0 -1 0 0 0 0 0 0 -1 -1 0 -1 -1 -1 -1 
0 -1 -1 -1 -1 -1 -1 -1 -1 0 0 0 0 -1 0 0 0 0 0 -1 0 0 0 0 0 0 -1 -1 0 0 3 0 0 -1 -1 -1 -1 0 0 0 
0 0 0 -1 -1 -1 -1 -1 0 0 0 0 0 -1 0 -1 0 0 -1 -1 0 0 0 0 F2 0 -1 -1 -1 -1 -1 0 0 0 -1 0 0 0 0 0 
5 -1 -1 -1 -1 -1 0 0 0 0 0 0 0 0 0 -1 0 0 -1 0 0 0 0 0 0 0 -1 0 0 0 0 0 0 0 -1 0 0 0 0 0 
0 0 0 0 -1 0 0 0 0 0 0 0 0 0 0 -1 0 0 -1 0 0 0 0 0 -1 -1 0 2 0 0 0 0 0 0 -1 0 0 0 0 0 
-1 -1 0 0 -1 0 0 0 0 0 0 0 -1 -1 -1 -1 -1 -1 -1 9 0 0 5 -1 0 0 0 3 0 0 0 0 0 0 -1 0 0 0 -1 0 
-1 0 0 -1 -1 0 0 F5 9 0 0 0 0 -1 -1 -1 -1 0 -1 0 0 0 0 -1 0 0 0 0 0 0 0 0 0 0 0 0 0 0 -1 0 
-1 0 -1 -1 0 0 0 0 -1 -1 -1 -1 -1 0 0 -1 0 0 0 0 0 0 0 0 0 0 0 0 0 0 0 -1 -1 0 0 0 0 0 -1 0 
-1 0 -1 -1 0 0 0 -1 0 0 0 0 0 0 0 0 0 0 0 0 -1 0 0 0 0 0 0 0 0 -1 -1 -1 -1 -1 -1 -1 -1 -1 -1 -1 
0 0 -1 -1 0 -1 0 -1 0 0 0 -1 -1 -1 -1 -1 -1 0 -1 0 -1 0 0 0 0 0 -1 0 0 7 0 -1 -1 0 0 4 0 0 -1 -1 
0 0 -1 0 0 -1 -1 -1 0 6 0 0 0 0 0 0 -1 0 -1 0 -1 0 0 0 0 0 0 0 0 0 0 -1 -1 0 0 0 0 0 0 0 
0 0 -1 0 0 -1 -1 -1 0 0 0 0 0 -1 0 5 -1 0 -1 0 -1 0 0 -1 -1 0 -1 -1 0 -1 4 -1 -1 0 -1 F5 0 0 0 7 
0 0 -1 0 0 -1 -1 -1 0 0 0 0 0 -1 0 0 -1 0 -1 0 -1 0 0 -1 -1 0 0 0 -1 -1 0 -1 -1 0 -1 0 0 0 0 0 
0 0 -1 0 0 -1 -1 0 0 0 0 0 0 -1 0 0 -1 0 -1 0 0 -1 0 -1 -1 0 0 0 0 0 0 0 -1 F4 -1 6 0 0 0 0 
0 0 0 0 0 0 -1 0 0 0 0 0 0 -1 0 0 -1 0 -1 0 0 -1 0 -1 -1 0 0 0 0 0 0 0 -1 0 0 0 0 0 0 0 
0 0 0 0 0 0 0 0 0 0 0 0 -1 -1 0 -1 0 0 0 0 0 0 -1 -1 -1 0 0 0 -1 0 0 0 -1 0 0 0 0 0 0 0 
0 0 0 0 0 0 0 0 0 0 0 0 0 0 0 -1 0 0 0 0 0 0 -1 0 -1 0 0 0 0 0 0 0 0 F5 -1 0 0 -1 -1 -1 
0 0 0 0 0 -1 -1 0 -1 -1 0 0 0 0 0 -1 0 0 0 0 0 0 0 0 -1 0 0 0 -1 0 0 0 0 0 -1 0 0 0 0 0 
-1 -1 -1 -1 -1 -1 6 0 0 0 0 0 0 0 0 -1 9 0 0 -1 -1 -1 -1 0 -1 -1 -1 -1 -1 -1 -1 0 0 0 -1 -1 0 0 0 0 
0 0 0 -1 0 -1 0 0 0 0 -1 -1 0 0 0 -1 0 0 0 0 0 0 0 0 -1 0 0 -1 -1 -1 0 0 0 0 0 0 0 -1 -1 -1 
0 0 0 -1 0 -1 0 0 -1 0 0 0 0 -1 0 -1 0 0 -1 0 0 0 0 0 -1 0 0 0 -1 0 0 0 0 0 0 0 0 -1 -1 -1 
0 0 0 -1 0 0 0 F4 -1 0 0 0 0 0 0 0 -1 0 -1 0 -1 0 0 0 F1 0 0 -1 -1 0 0 0 0 0 0 6 0 0 0 0 
0 0 0 -1 0 0 0 0 0 0 0 -1 0 -1 0 0 -1 0 -1 -1 -1 0 0 -1 -1 0 0 0 0 0 0 0 S 0 0 0 0 0 0 0 
0 0 0 0 0 0 0 0 0 -1 0 -1 -1 -1 -1 -1 -1 -1 -1 -1 -1 0 0 -1 -1 -1 -1 -1 -1 0 0 0 -1 0 0 0 0 0 0 0 
