10 10 100 10
0 2 0 -1 0 0 0 -1 0 1 
S1 -1 S -1 0 0 0 S2 0 0 
0 -1 -1 -1 0 0 0 0 -1 0 
0 -1 0 0 -1 -1 -1 0 6 0 
0 -1 -1 -1 0 0 0 0 0 0 
0 -1 -1 -1 0 0 -1 -1 0 0 
-1 -1 -1 -1 F2 -1 -1 -1 3 G 
-1 -1 0 -1 0 0 -1 -1 0 0 
-1 0 G2 0 0 0 -1 6 0 0 
0 G1 0 -1 -1 -1 -1 0 0 0 
