15 15 100 100
0 0 0 S4 0 0 0 0 0 -1 -1 -1 -1 -1 0 
0 0 0 0 8 0 0 0 0 0 0 0 3 0 2 
0 -1 0 0 -1 0 0 0 0 0 0 0 -1 S1 8 
0 -1 0 0 -1 0 0 0 0 0 5 0 -1 0 0 
0 0 0 0 -1 0 0 -1 -1 -1 -1 8 0 0 0 
0 0 0 0 0 0 0 0 10 0 S 0 0 0 G3 
0 -1 -1 -1 -1 0 0 -1 -1 -1 -1 -1 -1 -1 0 
-1 -1 -1 -1 -1 -1 0 -1 10 G2 0 2 0 0 0 
0 -1 -1 0 0 0 0 -1 0 0 0 0 -1 0 0 
0 -1 0 0 0 0 0 -1 0 0 0 0 -1 0 0 
0 -1 0 0 0 0 0 0 -1 -1 -1 -1 -1 -1 -1 
0 0 0 0 0 0 0 0 0 G4 0 0 0 0 S2 
S3 0 0 0 5 0 0 0 -1 -1 0 0 0 0 0 
G 0 -1 -1 -1 -1 0 0 0 0 0 0 0 0 G1 
0 0 0 -1 -1 -1 -1 -1 -1 -1 -1 -1 -1 0 0 
