25 25 100 100
0 0 S6 0 G3 0 -1 8 0 0 0 3 0 0 -1 -1 -1 -1 -1 0 0 0 0 0 0 
-1 -1 0 0 0 0 0 0 0 0 0 0 0 0 0 S2 0 0 0 0 0 0 0 0 S1 
-1 -1 0 0 0 0 0 0 7 0 9 0 -1 -1 -1 -1 -1 -1 -1 0 0 0 0 0 0 
-1 0 0 0 0 S 0 G7 0 0 0 0 0 0 0 0 -1 -1 -1 -1 -1 -1 -1 0 -1 
-1 0 0 0 0 0 0 0 -1 0 0 -1 0 0 0 0 -1 0 S7 0 0 0 -1 -1 -1 
-1 0 3 0 0 0 0 0 -1 0 0 0 0 -1 0 0 -1 0 0 0 0 0 -1 -1 0 
0 0 0 0 0 0 0 0 -1 0 -1 0 0 0 0 0 -1 0 0 0 0 S4 0 0 0 
0 0 0 -1 0 0 -1 -1 -1 -1 -1 -1 -1 0 0 0 -1 0 0 0 0 0 0 0 0 
0 0 0 -1 0 0 0 0 -1 -1 0 -1 -1 -1 -1 -1 -1 0 0 0 0 0 0 0 0 
0 0 0 0 0 0 0 0 -1 0 0 8 0 0 0 0 -1 0 0 0 -1 -1 -1 -1 -1 
0 0 0 0 0 0 0 0 0 0 0 0 0 -1 -1 -1 -1 -1 -1 0 0 0 S5 0 0 
0 0 0 0 0 0 0 0 0 5 0 0 0 0 0 0 0 0 0 0 0 0 0 0 0 
0 0 -1 -1 0 0 0 -1 0 0 0 9 -1 0 0 0 0 0 0 0 0 0 0 0 0 
0 0 0 0 0 0 0 -1 0 0 0 0 0 0 0 0 0 0 0 0 0 0 0 0 0 
6 0 0 0 0 0 0 -1 -1 0 0 0 0 0 -1 0 0 0 0 0 -1 -1 -1 -1 -1 
0 0 0 0 0 0 0 0 -1 0 0 0 0 0 0 0 0 0 0 0 0 8 0 0 0 
G1 0 0 0 0 -1 0 3 -1 0 -1 0 0 0 0 0 0 G6 1 0 0 0 0 0 7 
0 G5 0 0 0 -1 0 0 -1 0 0 0 0 0 0 0 0 1 G2 0 0 0 0 0 0 
0 0 0 0 0 0 0 0 -1 0 0 0 0 0 0 9 0 0 0 0 0 0 -1 0 0 
0 0 0 0 0 0 0 0 -1 -1 -1 -1 0 0 0 0 0 0 0 0 2 0 0 5 0 
0 -1 -1 -1 -1 -1 -1 -1 -1 -1 -1 6 0 -1 0 0 0 0 -1 -1 -1 9 0 0 0 
-1 0 0 G 0 0 0 0 -1 0 0 0 0 -1 0 0 0 0 0 0 0 0 0 0 0 
0 0 0 0 0 0 0 0 0 0 0 0 0 -1 0 0 -1 0 0 0 -1 0 1 0 0 
G4 S3 0 0 0 0 0 0 -1 0 0 0 0 -1 -1 0 -1 0 0 0 -1 0 0 0 0 
-1 0 0 0 -1 -1 -1 -1 -1 0 0 0 0 -1 -1 -1 -1 -1 -1 -1 -1 -1 -1 -1 0 
